NNNNNNNNNNNNNNNNNFFF
NNNNNNNNNNNNNNNNNNFF
NNNNNFFNNNNNNNNNNNNF
NNNNNFFFFNNNNNNNNNNN
NNNNNFFFFFNNNNNNNNNN
RNNNNFFFFFFFNNNNNNNN
RRRNFFFFFFNRRRRRRRNN
NRRRNFFFFNRRNNNNNRRN
NNNRRNFFFNRNNNNNNNRR
NNNNRRRNRRRNNNNNNNNR
NNNNNNRRRNNNNNNNNNNN
NNNNNNNNNNNNNNNNNNNN
NNFFFNNNNNNNNNNNNNNN
NNNFFNNNNNNNFFFFNNNN
NNFFNNNNNNNNNFFFFNNN
NNNNNNNNNNFFFFFFNNNN
NNNNNNNNNNNNFFFNNNNN
NNNNNNNNNNNNNNNNNNNN
NNNNNNNNNNNNNNNNNRRR
NNNNNNNNNNNNNNNNRRRR